-0;+2;-2;0;D;X
-0;+3;-3;1;T;X
-1;-1;+2;2;T;X
-1;-2;+3;2;T;X
-1;-3;+4;2;T;X
-1;-4;+5;2;T;X
-1;-5;+6;3;T;X
-1;-6;+7;3;T;X
-1;-7;+8;3;T;X
-1;+0;+1;2;T;X
-1;+1;+0;2;T;X
-1;+2;-1;2;T;X
-1;+3;-2;2;T;X
-1;+4;-3;1;T;X
-2;-1;+3;2;T;X
-2;-2;+4;0;D;X
-2;-3;+5;0;D;X
-2;-4;+6;3;T;X
-2;-5;+7;3;T;V
-2;-6;+8;3;T;V
-2;+0;+2;2;T;K
-2;+1;+1;2;T;X
-2;+2;+0;2;T;T
-2;+3;-1;2;T;X
-2;+4;-2;0;T;X
-2;+5;-3;0;T;X
-3;-1;+4;2;T;X
-3;-2;+5;0;D;X
-3;-3;+6;0;D;X
-3;-4;+7;3;T;V
-3;-5;+8;3;T;C
-3;+0;+3;2;T;X
-3;+1;+2;0;D;X
-3;+2;+1;2;T;X
-3;+3;+0;2;T;X
-3;+4;-1;0;T;X
-3;+5;-2;0;T;X
-3;+6;-3;0;D;X
-4;-1;+5;2;T;X
-4;-2;+6;2;T;X
-4;-3;+7;0;D;X
-4;+0;+4;2;T;X
-4;+1;+3;2;T;X
-4;+2;+2;2;T;X
-4;+3;+1;2;T;X
-4;+4;+0;4;T;X
-4;+5;-1;4;T;X
-4;+6;-2;0;D;X
-5;-1;+6;2;T;X
-5;-2;+7;2;T;X
-5;+0;+5;2;T;X
-5;+3;+2;2;T;X
-5;+4;+1;4;T;V
-5;+5;+0;4;T;V
-6;-1;+7;2;T;X
-6;+0;+6;2;T;T
-6;+1;+5;2;T;X
-6;+3;+3;4;T;X
-6;+4;+2;4;T;V
-6;+5;+1;4;T;X
-7;+0;+7;2;T;X
-7;+1;+6;2;T;X
-7;+3;+4;4;T;X
-7;+4;+3;0;D;X
-7;+5;+2;4;T;X
-7;+6;+1;0;D;X
-8;+4;+4;4;T;X
-8;+5;+3;4;T;C
+0;-1;+1;2;T;X
+0;-2;+2;0;D;X
+0;-3;+3;2;T;X
+0;-4;+4;2;T;X
+0;-5;+5;2;T;X
+0;-6;+6;3;T;X
+0;-7;+7;3;T;X
+0;+0;+0;2;T;C
+0;+1;-1;2;T;X
+0;+4;-4;1;T;X
+1;-1;+0;2;T;X
+1;-2;+1;0;D;X
+1;-3;+2;2;T;X
+1;-4;+3;2;T;T
+1;-5;+4;2;T;X
+1;-6;+5;2;T;X
+1;-7;+6;2;T;X
+1;+0;-1;2;T;X
+1;+1;-2;2;T;K
+1;+2;-3;2;T;X
+1;+3;-4;0;T;X
+1;+4;-5;4;T;X
+1;+5;-6;4;T;X
+2;-1;-1;2;T;X
+2;-2;+0;0;D;X
+2;-4;+2;2;T;X
+2;-5;+3;2;T;X
+2;-6;+4;2;T;X
+2;-7;+5;0;D;X
+2;+0;-2;2;T;X
+2;+1;-3;2;T;X
+2;+2;-4;0;T;X
+2;+3;-5;1;T;X
+2;+4;-6;1;T;X
+2;+5;-7;1;T;X
+3;-1;-2;0;D;X
+3;-2;-1;2;T;K
+3;-7;+4;0;D;X
+3;+0;-3;0;T;X
+3;+1;-4;0;D;X
+3;+2;-5;0;D;X
+3;+3;-6;1;T;X
+3;+4;-7;1;T;X
+4;-1;-3;0;D;X
+4;-2;-2;2;T;X
+4;-3;-1;2;T;X
+4;-4;+0;2;T;X
+4;-5;+1;2;T;X
+4;+0;-4;0;T;X
+4;+1;-5;0;D;X
+4;+2;-6;0;T;X
+4;+3;-7;4;T;X
+4;+4;-8;4;T;X
+5;-1;-4;0;D;X
+5;-2;-3;1;T;X
+5;-3;-2;2;T;X
+5;-4;-1;2;T;X
+5;-5;+0;2;T;X
+5;-6;+1;2;T;X
+5;+0;-5;0;T;X
+5;+1;-6;0;T;X
+5;+2;-7;4;T;X
+6;-1;-5;0;D;X
+6;-2;-4;1;T;X
+6;-3;-3;1;T;X
+6;-4;-2;2;T;X
+6;-5;-1;2;T;T
+6;-6;+0;2;T;X
+6;+0;-6;1;T;V
+6;+1;-7;1;T;V
+7;-1;-6;1;T;V
+7;-2;-5;4;T;X
+7;-3;-4;4;T;X
+7;-4;-3;1;T;X
+7;-5;-2;2;T;X
+7;-6;-1;2;T;X
+7;+0;-7;1;T;C
+8;-4;-4;4;T;X
+8;-5;-3;1;T;X
+8;-6;-2;1;T;X
+9;-5;-4;1;T;X
+9;-6;-3;1;T;X