-1;-1;+2;0;D;X
-1;-2;+3;0;D;X
-1;-3;+4;1;T;X
-1;+0;+1;0;T;X
-1;+1;+0;0;T;X
-1;+2;-1;0;T;X
-2;-1;+3;0;D;X
-2;-2;+4;1;T;X
-2;+0;+2;1;T;X
-2;+1;+1;1;T;T
-2;+2;+0;0;T;X
-3;-1;+4;0;D;X
-3;+0;+3;1;T;V
-3;+1;+2;1;T;C
-3;+2;+1;1;T;X
-4;+0;+4;0;D;X
-4;+1;+3;1;T;X
-5;+3;+2;0;D;X
+0;-1;+1;0;T;X
+0;-2;+2;0;D;X
+0;-3;+3;1;T;X
+0;-4;+4;1;T;X
+0;+1;-1;0;T;X
+1;-1;+0;0;T;X
+1;-2;+1;0;T;X
+1;-3;+2;1;T;X
+1;-4;+3;1;T;X
+1;+0;-1;0;T;X
+1;+2;-3;2;T;C
+2;-1;-1;0;T;X
+2;-2;+0;0;T;X
+2;+0;-2;0;T;X
+2;+1;-3;2;T;X
+2;+2;-4;2;T;X
+3;-1;-2;0;T;X
+3;-2;-1;0;D;X
+3;+2;-5;0;D;X
+4;-1;-3;0;T;X
+4;-2;-2;1;T;X
+5;-2;-3;1;T;X
+5;-3;-2;1;T;X
+6;-3;-3;0;D;X