+4;-7;+3;0;D;X
+5;-7;+2;0;D;X
+1;-6;+5;0;D;X
+3;-6;+3;0;D;X
+4;-6;+2;0;D;X
+5;-6;+1;0;D;X
+6;-6;+0;4;T;X
+7;-6;-1;2;T;X
+8;-6;-2;2;T;X
+2;-5;+3;0;D;X
+3;-5;+2;0;D;X
+4;-5;+1;0;T;X
+5;-5;+0;4;T;X
+6;-5;-1;0;T;X
+7;-5;-2;2;T;V
+8;-5;-3;2;T;C
+1;-4;+3;0;D;X
+2;-4;+2;1;T;X
+3;-4;+1;0;T;X
+4;-4;+0;0;T;X
+5;-4;-1;0;T;X
+6;-4;-2;0;T;X
+7;-4;-3;2;T;X
+0;-3;+3;0;D;X
+1;-3;+2;1;T;T
+2;-3;+1;0;T;X
+3;-3;+0;1;T;X
+4;-3;-1;1;T;X
+5;-3;-2;0;T;X
+6;-3;-3;0;T;X
+0;-2;+2;1;T;C
+1;-2;+1;1;T;V
+2;-2;+0;0;T;X
+3;-2;-1;1;T;X
+4;-2;-2;0;T;X
+5;-2;-3;0;T;X
+3;-1;-2;0;T;X
+4;-1;-3;1;T;X
+5;-1;-4;0;D;X
-2;+0;+2;0;D;X
-1;+0;+1;1;T;T
+0;+0;+0;1;T;C
+3;+0;-3;1;T;V
+4;+0;-4;1;T;C
+6;+0;-6;0;T;X
-1;+1;+0;1;T;V
+0;+1;-1;0;T;X
+1;+1;-2;0;T;X
+2;+1;-3;0;T;X
-1;+2;-1;2;T;X
+3;+2;-5;0;T;X
+4;+2;-6;0;T;X
-2;+3;-1;2;T;X
-1;+3;-2;2;T;C
+0;+3;-3;2;T;X
