+2;-6;+4;2;T;V
+3;-6;+3;2;T;X
+1;-5;+4;2;T;X
+2;-5;+3;2;T;C
+3;-5;+2;0;T;X
+4;-5;+1;0;D;X
+5;-5;+0;0;D;X
+6;-5;-1;0;D;X
+2;-4;+2;0;T;X
+3;-4;+1;1;T;X
+4;-4;+0;0;D;X
+5;-4;-1;2;T;X
+6;-4;-2;2;T;C
+7;-4;-3;2;T;X
+2;-3;+1;1;T;V
+3;-3;+0;1;T;C
+4;-3;-1;0;T;X
+5;-3;-2;2;T;V
+6;-3;-3;2;T;X
-2;-2;+4;1;T;V
-1;-2;+3;0;D;X
+0;-2;+2;0;D;X
+1;-2;+1;0;T;X
+2;-2;+0;0;T;X
+3;-2;-1;0;T;X
+4;-2;-2;0;T;X
-3;-1;+4;1;T;X
-2;-1;+3;1;T;C
-1;-1;+2;0;T;X
+0;-1;+1;0;D;X
+1;-1;+0;1;T;X
+2;-1;-1;1;T;X
+3;-1;-2;0;T;X
-3;+0;+3;1;T;X
-2;+0;+2;0;T;X
-1;+0;+1;0;T;X
+0;+0;+0;0;T;X
+1;+0;-1;1;T;X
+2;+0;-2;0;T;X
+3;+0;-3;4;T;X
-3;+1;+2;0;T;X
-2;+1;+1;0;T;X
-1;+1;+0;1;T;V
+0;+1;-1;0;T;X
+1;+1;-2;0;T;X
+2;+1;-3;4;T;V
+3;+1;-4;4;T;C
-4;+2;+2;0;T;X
-3;+2;+1;0;T;X
-2;+2;+0;1;T;X
-1;+2;-1;1;T;C
+1;+2;-3;0;T;X
+2;+2;-4;4;T;X
-5;+3;+2;0;T;X
-4;+3;+1;4;T;V
-3;+3;+0;0;D;X
-2;+3;-1;0;D;X
+1;+3;-4;0;T;X
+2;+3;-5;4;T;X
-5;+4;+1;4;T;C
-4;+4;+0;4;T;X
+1;+4;-5;0;T;X
